Barcode1	Barcode2	ID
CTCGTGCAG	CGAGTGCAG	A1
TGCATGCAG	TGCATGCAG	A2
ACTATGCAG	TAGTTGCAG	A3
CAGATGCAG	TCTGTGCAG	A4
AACTTGCAG	AGTTTGCAG	A5
GCGTTGCAG	ACGCTGCAG	A6
CGATTGCAG	ATCGTGCAG	A7
GTAATGCAG	TTACTGCAG	A8
AGGGTGCAG	CCCTTGCAG	A9
GATGTGCAG	CATCTGCAG	A10
TCAGTGCAG	CTGATGCAG	A11
TGCGATGCAG	TCGCATGCAG	A12
CGCTTTGCAG	AAGCGTGCAG	B1
TCACGTGCAG	CGTGATGCAG	B2
CTAGGTGCAG	CCTAGTGCAG	B3
ACAAATGCAG	TTTGTTGCAG	B4
TTCTGTGCAG	CAGAATGCAG	B5
AGCCGTGCAG	CGGCTTGCAG	B6
GTATTTGCAG	AATACTGCAG	B7
CTGTATGCAG	TACAGTGCAG	B8
ACCGTTGCAG	ACGGTTGCAG	B9
GCTTATGCAG	TAAGCTGCAG	B10
GGTGTTGCAG	ACACCTGCAG	B11
AGGATTGCAG	ATCCTTGCAG	B12
ATTGATGCAG	TCAATTGCAG	C1
CATCTTGCAG	AGATGTGCAG	C2
CCTAGTGCAG	CTAGGTGCAG	C3
GAGGATGCAG	TCCTCTGCAG	C4
GGAAGTGCAG	CTTCCTGCAG	C5
GTCAATGCAG	TTGACTGCAG	C6
TAATATGCAG	TATTATGCAG	C7
TACATTGCAG	ATGTATGCAG	C8
TCGTTTGCAG	AACGATGCAG	C9
GGTTGTTGCAG	ACAACCTGCAG	C10
CCAGCTTGCAG	AGCTGGTGCAG	C11
TTCAGATGCAG	TCTGAATGCAG	C12
TAGGAATGCAG	TTCCTATGCAG	D1
GCTCTATGCAG	TAGAGCTGCAG	D2
CCACAATGCAG	TTGTGGTGCAG	D3
CTTCCATGCAG	TGGAAGTGCAG	D4
GAGATATGCAG	TATCTCTGCAG	D5
ATGCCTTGCAG	AGGCATTGCAG	D6
AGTGGATGCAG	TCCACTTGCAG	D7
ACCTAATGCAG	TTAGGTTGCAG	D8
ATATGTTGCAG	ACATATTGCAG	D9
ATCGTATGCAG	TACGATTGCAG	D10
CATCGTTGCAG	ACGATGTGCAG	D11
CGCGGTTGCAG	ACCGCGTGCAG	D12
CTATTATGCAG	TAATAGTGCAG	E1
GCCAGTTGCAG	ACTGGCTGCAG	E2
GGAAGATGCAG	TCTTCCTGCAG	E3
GTACTTTGCAG	AAGTACTGCAG	E4
GTTGAATGCAG	TTCAACTGCAG	E5
TAACGATGCAG	TCGTTATGCAG	E6
TGGCTATGCAG	TAGCCATGCAG	E7
TATTTTTTGCAG	AAAAATATGCAG	E8
CTTGCTTTGCAG	AAGCAAGTGCAG	E9
ATGAAAGTGCAG	CTTTCATTGCAG	E10
AAAAGTTTGCAG	AACTTTTTGCAG	E11
GAATTCATGCAG	TGAATTCTGCAG	E12
GAACTTGTGCAG	CAAGTTCTGCAG	F1
GGACCTATGCAG	TAGGTCCTGCAG	F2
GTCGATTTGCAG	AATCGACTGCAG	F3
AACGCCTTGCAG	AGGCGTTTGCAG	F4
AATATGGTGCAG	CCATATTTGCAG	F5
ACGTGTTTGCAG	AACACGTTGCAG	F6
ATTAATTTGCAG	AATTAATTGCAG	F7
ATTGGATTGCAG	ATCCAATTGCAG	F8
CATAAGTTGCAG	ACTTATGTGCAG	F9
CGCTGATTGCAG	ATCAGCGTGCAG	F10
CGGTAGATGCAG	TCTACCGTGCAG	F11
CTACGGATGCAG	TCCGTAGTGCAG	F12
GCGGAATTGCAG	ATTCCGCTGCAG	G1
TAGCGGATGCAG	TCCGCTATGCAG	G2
TCGAAGATGCAG	TCTTCGATGCAG	G3
TCTGTGATGCAG	TCACAGATGCAG	G4
TGCTGGATGCAG	TCCAGCATGCAG	G5
ACGACTAGTGCAG	CTAGTCGTTGCAG	G6
TAGCATGGTGCAG	CCATGCTATGCAG	G7
TAGGCCATTGCAG	ATGGCCTATGCAG	G8
TGCAAGGATGCAG	TCCTTGCATGCAG	G9
TGGTACGTTGCAG	ACGTACCATGCAG	G10
TCTCAGTGTGCAG	CACTGAGATGCAG	G11
CCGGATATTGCAG	ATATCCGGTGCAG	G12
CGCCTTATTGCAG	ATAAGGCGTGCAG	H1
AACCGAGATGCAG	TCTCGGTTTGCAG	H2
ACAGGGAATGCAG	TTCCCTGTTGCAG	H3
ACGTGGTATGCAG	TACCACGTTGCAG	H4
CCATGGGTTGCAG	ACCCATGGTGCAG	H5
CGCGGAGATGCAG	TCTCCGCGTGCAG	H6
CGTGTGGTTGCAG	ACCACACGTGCAG	H7
GCTGTGGATGCAG	TCCACAGCTGCAG	H8
GGATTGGTTGCAG	ACCAATCCTGCAG	H9
GTGAGGGTTGCAG	ACCCTCACTGCAG	H10
TATCGGGATGCAG	TCCCGATATGCAG	H11
TTCCTGGATGCAG	TCCAGGAATGCAG	H12
